{
    "level": 1,
    "optimalPath": 9,
    "targetScore": 45,
    "startX": -1,
    "startY": 0,
    "gridWidth": 9,
    "gridHeight": 9,
    "grid": [
         1, 1, 1, 1, 1, 1, 1, 1, 1 ,
         2, 2, 2, 2, 2, 2, 2, 2, 2 ,
         3, 3, 3, 3, 3, 3, 3, 3, 3 ,
         4, 4, 4, 4, 4, 4, 4, 4, 4 ,
         5, 5, 5, 5, 5, 5, 5, 5, 5 ,
         6, 6, 6, 6, 6, 6, 6, 6, 6 ,
         7, 7, 7, 7, 7, 7, 7, 7, 7 ,
         8, 8, 8, 8, 8, 8, 8, 8, 8 ,
         9, 9, 9, 9, 9, 9, 9, 9, 5 
    ],

    "comment": "11-6-13-8-14-9-3-8",
    "isBlind": false,
    "totalTime": 60 

}
